R 1080 720
NO textures/colorstone.xpm
SO textures/eagle.xpm

WE textures/wood.xpm
EA textures/mossy.xpm
S textures/barrel.xpm
F 110,150,120
C 100,100,102
11111111111111111111111111111
10000000001100000000000000001
10110000011100000010000010001
10010000000000020000000010001
10110000110100000000000010201
10000001110111000111011100001
11110100000000100000000010001
11110100110111011101010010101
11000001110101011100000000201
10001000020000000000000010201
10000000000000001101010010001
11000000110101011101011010001
11110110000101000001010010N01
11111111111111111111111111111