R 3274723 44958
NO textures/colorstone.xpm
SO textures/eagle.xpm
WE textures/redbrick.xpm
EA textures/mossy.xpm
S textures/greenlight.xpm
C 100,100,100
F 150,150,150
1111111111111111111111111
1001110000000000000000001
1001N10000000000001022001
1001110000000200001000201
1000100100000000001020001
1000000000200000001000201
1000000000000000001002001
1002000000010000001000001
1000000000000000010000001
1000000000000000000000001
1000000000000000001000001
1111111111111111111111111
