R 500 500
NO textures/colorstone.xpm
SO textures/eagle.xpm
WE textures/wood.xpm
EA textures/mossy.xpm
S textures/barrel.xpm
F a255,255,255
C 100,100,102
11111111111111111111111111111
10000000001100000000000000001
10110020011100000010000010001
10010000000000000000200010001
10110000110100000000000010001
10000001110111000111011100001
11110100000000100000000010021
11110100110111011101010010S01
11000001110101011100000000021
10001000000000001101000010001
10000020000000001101010011001
11000000110101011101011010001
11110110000101000001010010001
11111111111111111111111111111
