R 1080 720

NO textures/test.xpm

SO textures/redbrick.xpm

WE textures/eagle.xpm

EA textures/mossy.xpm


S textures/pillar.xpm

F 15,10,161

C 15700,10,102



11111111111111111111111111111
10000000001100000000000000001
10110000011100000010000010001
10010000000000000000000010001
10110000111100000000000010001
10000001110111000111011110001
11110110000000101110000010001
11110100110111011101010010001
11000111110101011100000000001
10001000000000001101000010001
10000000000000001101010010001
11000000110101011101011010001
11110110000101000001010010N01
11111111111111111111111111111